F 3 1 1 1 1 1 1 1 1 1 1 1 1 1 1 1 1 1 1 1 1 1 1 1 1 3 F 
2 1 0 0 0 0 0 0 0 0 0 0 0 0 0 0 0 0 0 0 0 0 0 0 0 0 1 2 
2 1 0 1 1 1 1 0 1 1 4 1 1 4 0 1 1 1 1 1 1 1 0 1 1 0 1 2 
2 1 0 1 4 1 1 0 0 0 0 0 0 0 0 1 1 1 1 1 1 1 0 1 1 0 1 2 
2 1 0 0 0 0 0 0 1 1 1 1 1 0 1 4 M 1 4 1 1 1 0 1 4 0 1 2 
2 1 0 1 1 1 0 1 1 1 1 1 1 0 0 0 0 0 0 0 0 0 0 0 0 0 1 2 
2 1 0 1 4 1 0 1 1 1 1 1 1 0 1 1 1 1 1 1 0 1 1 1 1 0 1 2 
2 1 0 0 0 0 0 1 1 4 1 M 1 0 1 1 1 1 1 1 0 1 1 1 1 0 1 2 
2 1 0 1 1 1 0 0 0 0 0 0 0 0 0 1 1 1 1 1 0 1 1 4 1 0 1 2 
2 1 0 1 1 1 1 1 1 0 1 1 1 1 0 4 1 1 M 1 0 0 0 0 0 0 1 2 
2 1 0 1 4 1 1 4 1 0 1 1 1 1 0 0 0 0 0 0 0 1 1 1 1 0 1 2 
2 1 0 0 0 0 0 0 0 0 1 1 1 1 0 1 1 1 0 1 1 1 1 1 1 0 1 2 
2 1 0 1 4 1 0 4 1 1 1 M 4 1 0 4 1 1 0 1 4 1 1 1 1 0 1 2 
2 1 0 0 0 0 0 0 0 0 0 0 0 0 0 0 0 0 0 0 0 0 0 0 0 0 1 2 
2 1 1 1 1 1 1 1 1 1 1 1 ? 1 1 1 1 1 1 M 1 1 1 1 1 1 1 2 
1 0 0 0 0 0 0 0 0 0 0 0 0 0 0 0 0 0 0 0 0 0 0 0 0 0 0 1 
