F 3 3 3 3 1 1 1 1 1 1 4 4 4 4 4 4 4 1 1 1 1 1 3 3 3 3 F 
2 1 1 1 1 0 0 0 0 0 0 0 0 0 0 0 0 0 0 0 0 0 0 1 1 1 1 2 
2 1 5 5 5 0 0 0 0 0 0 0 0 0 0 0 0 0 0 0 0 0 0 5 5 5 1 2 
2 1 1 1 1 0 0 0 0 0 0 0 0 0 0 0 0 0 0 0 0 0 0 1 1 1 1 2 
2 M 5 2 1 0 0 0 0 0 0 0 0 0 0 0 0 0 0 0 0 0 0 1 2 5 M 2 
5 5 5 2 1 0 1 1 1 1 0 1 1 1 1 0 1 1 1 1 0 0 0 1 2 5 5 5 
1 1 1 2 1 0 4 4 4 4 0 4 4 4 4 0 4 4 4 4 0 0 0 1 2 1 1 1 
1 1 1 2 1 0 0 0 0 0 0 0 0 0 0 0 0 0 0 0 0 0 0 1 2 1 1 1 
1 1 1 2 1 0 0 0 0 0 0 0 0 0 0 0 0 0 0 0 0 0 0 1 2 1 1 1 
1 1 1 2 1 0 0 0 0 0 0 0 0 0 0 0 0 0 0 0 0 0 0 1 2 1 1 1 
1 1 1 2 1 0 0 0 1 1 1 1 0 1 1 1 1 0 1 1 1 1 0 1 2 1 1 1 
1 1 1 2 1 0 0 0 4 4 4 4 0 4 4 4 4 0 4 4 4 4 0 1 2 1 1 1 
1 1 1 2 1 0 0 0 0 0 0 0 0 0 0 0 0 0 0 0 0 0 0 1 2 1 1 1 
1 1 1 2 1 0 0 0 0 0 0 0 0 0 0 0 0 0 0 0 0 0 0 1 2 1 1 1 
1 1 1 2 1 0 0 0 0 0 0 0 0 0 0 0 0 0 0 0 0 0 0 1 2 1 1 1 
1 1 1 2 1 1 1 1 1 1 1 1 1 1 1 1 1 1 1 1 1 1 1 ? 2 1 1 1 
