1 1 1 1 1 1 1 1 F 1 1 1 1 1 1 1 1 1 1 1 1 1 1 1 1 1 1 1 
1 1 1 1 1 3 3 3 - 1 1 1 1 1 1 3 3 3 1 1 1 1 3 1 1 1 3 3 
2 1 1 1 2 1 1 3 0 5 5 5 5 5 5 1 1 1 0 0 0 0 1 5 5 2 1 1 
2 4 1 1 2 4 1 1 0 1 1 1 5 4 1 1 1 1 1 1 1 1 1 1 1 2 1 4 
0 0 2 3 5 5 2 1 5 2 1 1 5 5 0 5 1 0 0 0 0 0 0 1 2 0 0 0 
1 4 2 1 M 4 2 1 5 2 1 1 5 4 1 1 1 1 1 1 1 1 1 1 2 1 1 1 
2 0 0 3 2 5 5 1 5 2 2 1 5 5 0 2 1 0 1 1 1 1 0 1 2 1 1 1 
2 4 1 1 2 4 1 1 5 1 2 2 1 1 5 2 1 1 0 4 4 0 1 1 2 1 1 1 
0 0 2 3 5 5 2 1 5 1 1 2 2 1 5 2 1 1 1 0 0 2 3 3 2 1 4 1 
M 4 2 1 1 4 2 1 5 1 1 1 2 2 5 2 1 1 1 1 1 2 1 1 0 0 0 0 
2 0 0 3 2 5 5 1 5 1 1 1 1 2 5 2 1 1 M 1 1 2 1 1 1 1 1 1 
2 4 1 1 2 4 M 1 5 1 1 1 1 1 5 2 5 5 5 5 5 5 5 5 2 1 4 1 
0 0 2 3 5 5 2 1 5 1 1 1 1 1 5 2 0 1 1 4 1 4 1 0 2 0 0 0 
1 4 2 1 1 4 2 1 5 1 1 1 1 1 5 2 0 2 0 5 0 5 0 0 2 1 1 1 
2 0 0 3 5 5 5 1 5 M 4 4 2 0 1 2 0 2 1 4 1 4 1 1 2 1 1 1 
2 1 ? 1 1 1 1 1 0 0 0 0 0 0 5 5 0 0 5 0 5 0 5 0 5 0 5 0 
