0 0 F 0 0 0 0 F 0 0 0 0 0 F 0 0 0 0 0 F 0 0 0 0 0 F 0 0 
0 1 - 4 M 1 1 - 1 1 1 1 1 - 1 1 1 4 1 - 1 4 1 1 1 - 1 0 
0 2 0 0 0 0 0 0 0 0 0 0 0 0 0 0 0 0 0 0 0 0 0 0 0 0 2 0 
0 2 0 4 1 1 1 1 1 1 1 M 4 1 1 1 1 1 1 1 1 4 1 1 1 0 2 0 
0 2 0 0 0 0 0 0 0 0 0 0 0 0 0 0 0 0 0 0 0 0 0 0 2 0 2 0 
0 2 0 1 1 4 1 1 1 1 1 1 1 1 1 1 4 1 1 1 1 1 1 0 2 0 2 0 
0 2 0 2 0 0 0 0 0 0 0 0 0 0 0 0 0 0 0 0 0 0 2 0 2 0 2 0 
0 2 0 2 0 1 1 1 1 1 1 1 1 1 1 1 1 1 1 1 1 0 2 0 2 0 2 0 
0 2 0 2 0 2 0 4 1 1 1 1 1 M 1 1 1 1 1 4 1 0 2 0 2 0 2 0 
0 2 0 2 0 2 0 0 0 0 0 0 0 0 0 0 0 0 0 0 0 0 2 0 2 0 2 0 
0 2 0 2 0 2 1 1 1 4 1 1 1 1 1 1 1 1 4 1 1 1 2 0 2 0 2 0 
0 2 0 2 0 0 0 0 0 0 0 0 0 0 0 0 0 0 0 0 0 0 0 0 2 0 2 0 
0 2 0 2 1 1 1 4 1 1 1 1 1 1 1 1 1 4 1 1 1 1 1 1 2 0 2 0 
0 2 0 0 0 0 0 0 0 0 0 0 0 0 0 0 0 0 0 0 0 0 0 0 0 0 2 0 
0 2 1 1 1 M 1 1 1 4 1 1 1 1 ? 1 1 1 1 1 4 1 1 M 1 1 2 0 
0 0 0 0 0 0 0 0 0 0 0 0 0 0 0 0 0 0 0 0 0 0 0 0 0 0 0 0 
