1 1 1 1 1 1 1 1 1 1 1 1 F 0 0 F 1 1 1 1 1 1 1 1 1 1 1 1 
1 1 1 1 1 1 1 1 1 1 M 4 2 0 0 2 4 M 1 1 1 1 1 1 1 1 1 1 
1 1 1 1 1 1 1 1 1 1 2 0 0 0 0 0 0 2 1 1 1 1 1 1 1 1 1 1 
1 1 1 1 1 1 1 1 1 4 2 0 0 0 0 0 0 2 4 1 1 1 1 1 1 1 1 1 
1 1 1 1 1 1 1 1 2 0 0 0 0 0 0 0 0 0 0 2 1 1 1 1 1 1 1 1 
1 1 1 1 1 1 M 4 2 0 0 0 0 0 0 0 0 0 0 2 4 M 1 1 1 1 1 1 
1 1 1 1 1 1 2 0 0 0 0 0 0 0 0 0 0 0 0 0 0 2 1 1 1 1 1 1 
1 1 1 1 1 4 2 1 1 1 4 4 4 4 4 4 4 4 1 1 1 2 4 1 1 1 1 1 
1 1 1 1 2 0 0 0 0 0 0 0 0 0 0 0 0 0 0 0 0 0 0 2 1 1 1 1 
1 1 1 4 2 0 0 0 0 0 0 0 0 0 0 0 0 0 0 0 0 0 0 2 4 1 1 1 
1 1 2 0 0 0 0 0 0 0 0 0 0 0 0 0 0 0 0 0 0 0 0 0 0 2 1 1 
1 1 2 0 0 0 0 0 0 0 0 0 0 0 0 0 0 0 0 0 0 0 0 0 0 2 1 1 
1 1 2 1 1 1 1 1 1 1 1 1 1 1 1 1 1 1 1 1 1 1 1 1 1 2 1 1 
1 1 2 1 1 1 1 1 1 1 1 1 1 1 1 1 1 1 1 1 1 1 1 1 1 2 1 1 
1 1 2 1 1 1 1 1 1 1 1 1 1 ? 1 1 1 1 1 1 1 1 1 1 1 2 1 1 
0 0 0 0 0 0 0 0 0 0 0 0 0 0 0 0 0 0 0 0 0 0 0 0 0 0 0 0 
