F 3 3 3 3 1 1 1 1 1 1 1 1 M ? 1 1 1 1 1 1 1 1 3 3 3 3 F 
2 1 1 1 1 0 0 2 4 1 1 1 1 1 1 1 1 1 1 4 2 0 0 1 1 1 1 2 
2 1 1 1 1 0 0 2 4 1 1 1 1 1 1 1 1 1 1 4 2 0 0 1 1 1 1 2 
2 1 1 1 1 1 0 0 2 4 1 1 1 1 1 1 1 1 4 2 0 0 1 1 1 1 1 2 
2 4 1 4 1 1 0 0 2 4 1 1 1 1 1 1 1 1 4 2 0 0 1 1 4 1 4 2 
2 0 0 0 0 2 1 0 0 2 4 1 1 1 1 1 1 4 2 0 0 1 2 0 0 0 0 2 
2 4 1 1 4 2 1 0 0 2 4 1 1 1 1 1 1 4 2 0 0 1 2 4 1 1 4 2 
2 0 0 0 0 0 2 1 0 0 2 4 1 1 1 1 4 2 0 0 1 2 0 0 0 0 0 2 
2 4 M 1 M 4 2 1 0 0 2 4 1 1 1 1 4 2 0 0 1 2 4 M 1 M 4 2 
2 0 0 0 0 0 0 2 1 0 0 2 4 1 1 4 2 0 0 1 2 0 0 0 0 0 0 2 
2 4 1 1 1 1 4 2 1 0 0 2 4 1 1 4 2 0 0 1 2 4 1 1 1 1 4 2 
2 0 0 0 0 0 0 0 2 1 0 0 2 4 4 2 0 0 1 2 0 0 0 0 0 0 0 2 
2 4 1 1 1 1 1 4 2 1 0 0 0 0 0 0 0 0 1 2 4 1 1 1 1 1 4 2 
2 0 0 0 0 0 0 0 0 2 1 0 0 0 0 0 0 1 2 0 0 0 0 0 0 0 0 2 
2 4 1 1 1 1 1 1 4 2 1 4 4 0 0 4 4 1 2 4 1 1 1 1 1 1 4 2 
0 0 0 0 0 0 0 0 0 0 0 0 0 5 5 0 0 1 0 0 0 0 0 0 0 0 0 0 
