1 1 1 1 1 1 1 1 1 1 1 1 1 1 1 1 1 1 1 1 1 1 1 1 F 1 1 1 
1 1 1 4 1 1 1 1 1 1 1 1 1 1 1 1 1 1 1 1 1 1 1 1 - 1 1 1 
2 5 0 0 1 1 1 1 1 1 1 1 1 1 1 1 1 1 1 1 1 1 1 1 - 5 5 2 
2 5 4 0 0 1 4 1 1 1 1 1 1 1 1 1 1 1 1 1 1 1 1 4 - 5 5 2 
2 1 1 0 4 0 0 0 1 1 1 1 1 1 1 1 1 1 M 1 0 0 0 0 0 0 0 2 
2 1 1 0 1 0 1 1 0 0 0 4 1 1 1 1 1 0 0 0 1 4 1 1 1 1 1 2 
2 3 3 1 1 0 4 1 0 1 1 0 1 1 4 1 0 0 4 1 5 5 5 5 1 1 1 2 
2 1 1 0 0 0 0 0 0 1 1 1 0 0 0 0 0 1 1 1 1 1 1 0 0 0 5 2 
2 4 1 ? 1 1 1 1 1 1 1 1 1 1 1 1 1 0 5 5 5 2 0 1 4 1 1 2 
2 5 5 5 5 3 3 3 3 3 3 3 3 1 1 1 1 1 1 1 1 2 0 0 0 4 1 2 
2 1 1 1 5 1 1 1 1 M 4 4 4 4 1 1 1 1 1 1 1 2 1 1 0 0 0 0 
2 1 4 1 5 4 1 1 5 5 5 5 5 5 5 5 5 5 1 1 1 2 1 4 5 1 1 4 
2 0 0 0 0 0 1 1 1 1 1 1 1 1 1 1 1 1 1 1 1 2 0 0 5 5 0 0 
2 3 3 3 3 2 3 3 3 3 3 3 1 1 1 1 1 1 1 1 1 2 1 1 1 1 1 1 
1 1 1 1 1 2 1 1 1 1 1 1 1 1 1 1 1 1 1 1 1 2 M 1 1 1 1 1 
1 1 1 4 1 2 1 1 1 0 0 0 0 0 0 0 0 0 0 0 0 0 0 0 0 0 0 0 
