1 1 1 1 1 1 1 1 1 1 F 1 1 1 1 1 1 1 1 1 1 1 1 1 1 1 1 1 
1 1 1 1 1 1 1 1 1 1 - 1 1 1 1 1 1 1 1 1 1 1 1 1 1 1 1 1 
1 4 1 M 1 4 1 1 1 5 2 5 1 1 1 3 3 3 3 3 3 3 3 1 ? 1 1 1 
2 5 0 0 0 5 5 0 1 5 2 4 1 1 1 1 1 1 1 1 1 1 0 0 0 0 1 1 
2 5 1 1 1 1 1 1 1 5 2 5 1 1 1 1 4 1 1 1 1 1 1 1 1 1 1 4 
2 5 3 3 3 3 1 1 1 5 2 5 1 1 0 0 0 0 3 3 3 1 1 1 1 1 1 2 
2 5 1 1 1 1 1 1 4 5 2 5 1 1 4 1 1 1 1 1 1 1 1 1 4 1 1 2 
2 1 1 4 5 0 0 0 5 5 2 5 0 0 0 1 1 1 1 1 1 2 0 0 0 0 1 2 
2 5 0 5 5 1 1 1 1 5 2 5 1 1 1 1 1 1 M 4 1 2 0 1 1 1 1 2 
2 5 3 3 3 3 3 3 3 4 2 5 1 1 1 0 0 0 0 0 0 0 0 1 1 1 1 2 
2 5 1 1 1 1 4 1 1 5 2 5 1 1 1 4 1 1 1 1 1 1 1 1 4 1 1 2 
2 5 1 1 1 5 0 0 0 5 2 5 3 3 0 0 0 0 3 3 1 1 2 0 0 1 1 2 
2 5 4 1 1 1 1 1 1 5 2 5 1 1 1 1 1 1 1 1 4 1 2 1 1 1 1 2 
2 5 0 0 1 1 1 1 1 5 2 5 1 1 1 1 1 1 0 0 0 0 0 1 1 1 1 2 
2 1 1 1 1 1 M 1 1 1 2 1 1 1 1 1 1 1 1 1 1 1 1 1 1 1 1 2 
5 0 0 0 5 0 0 0 0 5 5 5 5 0 0 0 5 0 0 0 0 5 5 0 0 5 5 5 
