5 5 5 5 5 5 5 5 5 5 5 5 5 5 5 5 5 5 5 5 5 5 5 5 5 5 F 0 
2 3 3 3 3 3 3 3 3 3 3 3 3 3 3 3 3 3 3 3 3 3 3 2 - - - 0 
2 1 1 2 1 1 1 1 1 0 0 1 1 M 1 1 1 4 1 1 1 1 1 2 - 4 1 0 
2 1 1 2 1 0 0 0 0 0 0 0 0 0 0 0 0 0 0 0 0 0 0 0 0 0 2 0 
2 1 1 2 1 0 0 0 1 1 1 1 1 1 1 1 1 1 1 1 4 1 1 1 1 1 2 0 
2 1 1 2 1 1 1 0 1 0 0 0 0 0 0 0 0 0 0 0 0 0 0 0 0 0 0 0 
2 1 1 2 1 1 2 0 1 1 1 4 1 1 0 1 4 1 0 1 4 1 0 1 4 1 1 0 
2 1 1 2 1 1 2 0 0 2 0 0 0 0 0 0 0 0 0 0 0 0 0 0 0 0 0 0 
2 1 1 2 3 3 2 1 1 2 0 0 0 0 0 1 0 0 0 0 0 1 1 1 1 1 1 0 
2 1 1 2 1 1 2 1 1 2 1 1 1 1 0 1 4 0 1 1 1 1 1 M 1 1 1 0 
2 1 1 2 1 1 2 1 1 2 3 3 2 1 0 0 0 0 2 3 3 0 0 0 0 0 0 0 
2 1 1 2 1 1 2 1 1 2 1 1 2 1 1 1 1 1 2 1 1 0 0 0 0 0 0 0 
2 1 1 2 1 1 2 1 1 2 1 1 2 3 3 2 1 1 2 1 1 0 0 0 0 0 0 0 
2 1 1 2 1 1 2 1 1 2 1 1 2 1 1 2 1 0 2 0 0 0 1 4 4 4 1 0 
2 1 1 2 ? 1 2 1 1 2 1 M 2 1 1 2 1 1 2 0 0 0 2 0 0 0 0 0 
0 0 0 0 0 0 0 0 0 0 0 0 0 0 0 0 0 0 2 1 4 4 2 0 0 0 0 0 
