3 3 3 3 3 3 3 3 3 3 3 3 3 F 3 3 3 3 3 3 3 3 3 3 3 3 3 3 
1 4 1 1 1 1 1 1 4 1 1 1 1 2 1 1 1 4 1 1 1 4 1 M 4 1 1 4 
M 4 1 1 4 1 1 1 1 M 1 4 1 2 1 4 1 1 1 4 1 4 1 1 1 1 1 1 
1 0 0 0 0 0 0 2 1 2 0 0 0 0 0 0 2 1 2 0 0 0 1 1 1 1 1 1 
1 0 0 0 0 0 0 0 2 2 0 0 0 0 0 0 0 2 2 0 0 0 1 1 1 1 1 1 
1 0 0 0 0 0 0 0 0 2 0 0 0 0 0 0 0 0 2 0 0 0 1 1 1 1 1 1 
1 0 0 0 1 1 0 0 0 2 0 0 0 1 1 0 0 0 2 0 0 0 1 1 1 1 1 1 
1 0 0 0 1 1 0 0 0 2 0 0 0 1 1 0 0 0 2 0 0 0 1 1 1 1 1 1 
1 0 0 0 1 1 0 0 0 2 0 0 0 1 1 0 0 0 2 0 0 0 1 1 1 1 1 1 
1 0 0 0 1 1 0 0 0 2 0 0 0 1 1 0 0 0 2 0 0 0 1 1 1 1 1 1 
1 0 0 0 1 4 0 0 0 2 0 0 0 1 4 0 0 0 2 0 0 0 1 1 1 1 1 1 
1 0 0 0 0 0 0 0 0 2 0 0 0 0 0 0 0 0 2 0 0 0 0 0 0 0 0 1 
1 0 0 0 0 0 0 0 1 2 0 0 0 0 0 0 0 1 2 0 0 0 0 0 0 0 0 1 
1 0 0 0 0 0 0 1 1 2 0 0 0 0 0 0 1 1 2 0 0 0 0 0 0 0 0 1 
1 1 1 1 1 1 1 1 1 2 1 1 1 ? 1 1 1 1 2 1 1 1 1 1 1 1 1 1 
0 0 0 0 0 0 0 0 0 0 0 0 0 0 0 0 0 0 0 0 0 0 0 0 0 0 0 0 
