3 3 3 3 3 3 3 3 3 3 3 3 3 3 3 3 3 3 3 3 3 3 3 F 1 1 1 1 
1 1 4 1 1 1 1 4 1 1 1 1 1 4 1 1 1 1 1 4 1 1 1 2 1 1 1 1 
0 0 0 0 1 1 0 0 0 0 1 1 0 0 0 0 1 1 0 0 0 0 1 2 1 1 1 1 
1 1 1 1 1 4 1 1 1 1 4 1 1 1 1 1 1 4 1 1 1 1 1 2 1 1 1 1 
0 1 1 0 0 0 0 1 1 0 0 0 0 1 1 0 0 0 0 1 1 0 1 2 1 1 1 1 
1 4 1 1 1 1 1 1 4 1 1 1 4 1 1 1 1 1 1 4 1 1 1 2 1 1 1 1 
0 0 0 0 1 1 0 0 0 0 1 1 0 0 0 0 1 1 0 0 0 0 1 2 1 1 1 1 
1 1 1 1 4 1 1 1 1 1 4 1 1 1 1 1 4 1 1 1 1 1 1 2 1 1 1 1 
0 1 1 0 0 0 0 1 1 0 0 0 0 1 1 0 0 0 0 1 1 0 1 2 1 1 1 1 
1 1 4 1 1 1 1 1 4 1 1 1 1 1 4 1 1 1 1 4 1 1 1 2 1 1 1 1 
0 0 0 0 1 1 0 0 0 0 1 1 0 0 0 0 1 1 0 0 0 0 1 2 1 1 1 1 
M 1 1 1 1 ? 1 1 1 1 1 1 1 1 1 1 1 M 1 1 1 1 1 2 1 1 1 M 
0 0 0 0 0 0 0 0 0 0 0 0 0 0 0 0 0 0 0 0 0 0 0 0 1 0 0 0 
0 0 0 0 0 0 0 0 0 0 0 0 0 0 0 0 0 0 0 0 0 0 0 0 1 0 0 0 
0 0 0 0 0 0 0 0 0 0 0 0 0 0 0 0 0 0 0 0 0 0 1 1 1 1 1 0 
0 0 0 0 0 0 0 0 0 0 0 0 0 0 0 0 0 0 0 0 0 0 1 M 1 M 1 0 
