1 1 1 1 1 1 1 1 1 1 1 1 1 F F 1 1 1 1 1 1 1 1 1 1 1 1 1 
1 1 M 2 1 1 1 1 1 1 1 1 1 2 2 1 1 1 1 1 1 1 1 1 2 1 M 1 
1 0 0 2 0 0 1 1 1 1 1 0 0 2 2 0 0 1 1 1 1 1 0 0 2 0 0 1 
0 0 4 2 4 0 0 1 1 1 0 0 0 2 2 0 0 0 1 1 1 0 0 4 2 4 0 0 
0 1 1 2 1 1 1 1 1 0 0 4 1 2 2 1 4 0 0 1 1 0 1 1 2 1 1 1 
0 0 4 2 4 1 3 3 3 0 0 1 1 2 2 1 1 1 1 1 1 0 0 4 2 4 1 1 
1 0 0 2 0 0 1 1 1 0 0 4 1 2 2 M 4 1 1 1 1 1 0 0 2 0 0 1 
1 1 4 2 4 0 0 1 1 1 0 0 0 2 2 0 0 1 1 1 1 1 1 4 2 4 0 0 
1 1 1 2 1 1 0 1 1 1 1 0 0 2 2 0 0 0 1 3 3 1 1 1 2 1 1 0 
0 0 4 2 4 0 0 1 1 1 1 4 1 2 2 1 4 0 0 1 1 0 0 4 2 4 0 0 
1 0 0 2 0 0 1 1 1 1 1 1 1 2 2 1 1 0 0 1 1 1 0 0 2 0 0 1 
1 1 1 2 1 1 1 1 1 0 0 4 1 2 2 M 4 0 0 1 1 1 1 1 2 1 1 1 
1 1 1 1 1 1 1 1 1 1 0 0 0 2 2 0 0 0 1 1 1 1 1 1 1 1 1 1 
1 1 1 1 1 1 1 1 1 1 1 0 0 2 2 0 0 1 1 1 1 1 1 1 1 1 1 1 
1 1 1 1 1 1 1 1 ? 1 1 1 1 2 2 1 1 1 1 1 1 1 1 1 1 1 1 1 
0 0 0 0 0 0 0 0 0 0 0 0 0 2 2 0 0 0 0 0 0 0 0 0 0 0 0 0 
