1 - F 1 1 1 1 1 1 1 1 1 1 1 1 1 1 1 1 1 1 1 1 1 1 1 1 1 
1 1 - 1 1 1 1 1 1 1 1 1 1 1 1 1 1 1 1 1 1 1 1 1 1 1 1 1 
1 2 4 1 1 1 1 4 2 1 1 1 1 1 1 4 2 1 1 1 1 1 4 2 1 1 1 1 
1 4 2 1 1 1 1 2 4 1 1 1 1 1 1 2 4 1 1 1 1 1 2 4 1 1 1 1 
1 2 4 1 1 1 1 4 2 1 1 1 1 1 1 4 2 1 1 1 1 1 4 2 1 1 1 1 
1 4 2 1 1 1 1 2 4 1 1 1 1 1 1 2 4 1 1 1 1 1 2 4 1 1 1 1 
1 2 4 1 1 1 1 4 2 1 1 1 1 1 1 4 2 1 1 1 1 1 4 2 1 1 1 1 
1 4 2 1 1 1 1 2 4 1 1 1 1 1 1 2 4 1 1 1 1 1 2 4 1 1 1 1 
1 2 4 1 1 1 1 4 2 1 1 1 1 1 1 4 2 1 1 1 1 1 4 2 1 1 1 1 
1 4 2 1 1 1 1 2 4 1 1 1 1 1 1 2 4 1 1 1 1 1 2 4 1 1 1 1 
1 2 4 1 1 1 1 4 2 1 1 1 1 1 1 4 2 1 1 1 1 1 4 2 1 1 1 1 
1 4 2 1 1 1 1 2 4 1 1 1 1 1 1 2 4 1 1 1 1 1 2 4 1 1 1 1 
1 2 4 1 1 1 1 4 2 1 1 1 1 1 1 4 2 1 1 1 1 1 4 2 1 1 1 1 
1 4 2 1 1 1 1 2 4 1 1 1 1 1 1 2 4 1 1 1 1 1 2 4 1 1 1 1 
? 2 4 1 1 1 1 4 2 1 1 1 1 1 M 4 2 1 1 1 M 1 4 2 1 1 M 1 
1 0 0 0 0 0 0 0 0 0 0 0 0 0 0 0 0 0 0 0 0 0 0 0 0 0 0 1 
