1 1 1 1 1 1 1 1 1 1 1 1 F 1 1 1 1 1 1 1 1 1 1 1 1 1 1 1 
0 1 1 1 1 1 1 1 1 1 0 4 - 4 0 1 1 1 1 1 1 1 1 1 0 1 1 1 
1 0 3 3 3 2 3 3 3 3 3 0 2 0 3 3 3 3 3 2 3 3 3 0 1 1 1 1 
1 1 0 4 1 2 1 M 1 1 1 4 2 4 1 1 1 M 1 2 1 4 0 1 1 1 1 1 
1 1 1 0 3 2 3 2 3 3 3 0 2 0 3 3 3 2 3 2 3 0 1 1 1 1 1 1 
1 1 1 1 0 1 1 2 1 1 0 1 2 1 0 1 1 2 1 1 0 1 1 1 1 1 1 1 
1 2 3 3 3 0 1 2 1 0 3 3 2 3 3 0 1 2 1 0 3 3 3 3 3 3 2 1 
1 2 3 2 1 1 0 2 0 1 1 1 1 1 1 1 0 2 0 1 1 1 1 1 2 3 2 1 
1 1 1 2 1 1 0 2 0 1 1 1 1 1 1 1 0 2 0 1 1 1 1 1 2 1 1 1 
1 2 3 2 1 1 0 2 0 1 ? 1 4 1 1 1 0 2 0 0 0 0 1 1 2 3 2 1 
1 2 1 1 1 1 0 2 0 0 0 0 0 0 0 0 0 2 0 0 0 0 1 1 1 1 2 1 
1 2 3 2 1 1 0 2 0 1 0 0 0 0 0 1 0 2 0 0 4 0 1 1 2 3 2 1 
1 1 4 2 1 1 0 2 0 1 0 0 4 0 0 1 0 2 0 0 0 0 1 1 2 4 1 1 
1 2 3 2 M 1 0 2 0 1 0 0 0 0 0 1 0 2 0 1 1 1 1 M 2 3 2 1 
1 2 3 3 3 3 1 2 1 3 1 1 1 1 1 3 1 2 1 3 3 3 3 3 3 3 2 1 
1 2 1 1 1 1 0 2 0 1 0 0 0 0 0 1 0 2 0 1 1 1 1 1 1 1 2 1 
