1 1 1 1 1 1 1 1 1 1 1 F 1 1 1 1 F 1 1 1 1 1 1 1 1 1 1 1 
1 1 1 1 1 1 1 1 1 1 1 - 1 1 1 1 - 1 1 1 1 1 1 1 1 1 1 1 
1 1 1 4 1 1 1 1 1 2 0 - 1 1 1 1 - 0 2 1 1 1 M 1 4 1 1 1 
2 0 0 0 0 0 2 3 3 2 0 - 1 1 1 1 - 0 2 3 3 2 0 0 0 0 0 2 
2 0 1 1 1 0 2 1 1 1 0 - 1 1 1 1 - 0 1 1 1 2 0 1 1 1 0 2 
2 0 1 1 1 0 2 1 1 1 0 - 1 1 1 1 - 0 1 1 1 2 0 1 1 1 0 2 
2 0 1 4 1 0 2 1 1 1 0 - 1 1 1 1 - 0 1 1 1 2 0 1 4 1 0 2 
2 0 0 0 0 0 2 1 1 1 0 - 1 1 1 1 - 0 1 1 1 2 0 0 0 0 0 2 
2 0 1 1 1 0 2 1 1 1 0 - 1 1 1 1 - 0 1 1 1 2 0 1 1 1 0 2 
2 0 1 1 1 0 2 3 3 3 0 2 0 0 0 0 2 0 3 3 3 2 0 1 1 1 0 2 
2 0 1 1 1 0 1 1 1 2 0 2 1 1 1 1 2 0 2 1 1 1 0 1 1 1 0 2 
2 0 M 4 1 0 1 1 1 2 0 2 1 1 4 M 2 0 2 1 1 1 0 1 4 M 0 2 
2 0 0 0 0 0 1 1 1 2 0 5 5 5 5 5 5 0 2 1 1 1 0 0 0 0 0 2 
2 1 1 1 1 1 0 1 1 2 1 1 1 1 1 1 1 1 2 1 1 0 1 1 1 1 1 2 
2 1 1 1 1 1 1 0 M 2 1 1 1 1 ? 1 1 1 2 1 0 1 1 1 1 1 1 2 
0 0 0 0 0 0 0 0 0 0 0 0 0 0 0 0 0 0 0 0 0 0 0 0 0 0 0 0 
