0 0 0 0 0 0 0 F 2 3 3 3 3 3 3 3 3 3 3 2 F 0 0 0 0 0 0 0 
0 0 0 0 0 0 2 2 1 1 1 3 1 1 1 1 3 1 1 1 2 2 0 0 0 0 0 0 
0 0 0 0 0 2 2 1 1 1 1 1 0 M M 0 1 1 1 1 1 2 2 0 0 0 0 0 
0 0 0 0 2 2 1 1 1 1 3 1 0 0 0 0 1 3 1 1 1 1 2 2 0 0 0 0 
0 0 0 2 2 1 1 1 1 3 1 0 0 0 0 0 0 1 3 1 1 1 1 2 2 0 0 0 
0 0 2 2 3 3 3 3 3 1 0 0 0 0 0 0 0 0 1 3 3 3 3 3 2 2 0 0 
0 2 2 1 1 1 1 3 1 0 0 0 0 4 4 0 0 0 0 1 3 1 1 1 1 2 2 0 
2 2 1 1 1 1 1 1 0 0 0 0 0 0 0 0 0 0 0 0 1 1 1 1 1 1 2 2 
0 2 2 1 1 1 1 3 1 0 0 0 0 4 4 0 0 0 0 1 3 1 1 1 1 2 2 0 
0 0 2 2 1 1 1 1 3 1 0 0 0 0 0 0 0 0 1 3 1 1 1 1 2 2 0 0 
0 0 0 2 2 1 1 1 1 3 1 0 0 0 0 0 0 1 3 1 1 1 1 2 2 0 0 0 
0 0 0 0 2 2 1 1 1 1 3 1 0 0 0 0 1 3 1 1 1 1 2 2 0 0 0 0 
0 0 0 0 0 2 2 1 1 1 1 3 1 1 1 1 3 1 1 1 1 2 2 0 0 0 0 0 
0 0 0 0 0 0 2 2 1 1 1 1 1 1 1 1 1 1 1 1 2 2 0 0 0 0 0 0 
0 0 0 0 0 0 0 2 2 M 1 1 1 ? 1 1 1 1 M 2 2 0 0 0 0 0 0 0 
0 0 0 0 0 0 0 0 0 0 0 0 0 0 0 0 0 0 0 0 0 0 0 0 0 0 0 0 
