F 3 3 3 3 3 3 3 3 3 1 1 1 1 1 1 1 1 3 3 3 3 3 3 3 3 3 F 
2 1 1 1 1 1 1 1 1 1 0 0 0 0 0 0 0 0 1 1 1 1 1 1 1 1 1 2 
2 1 1 1 1 1 1 1 0 0 0 0 0 0 0 0 0 0 0 0 1 1 1 1 1 1 1 2 
2 1 1 1 M 1 1 0 0 0 0 0 0 0 0 0 0 0 0 0 0 1 1 M 1 1 1 2 
2 1 5 5 5 5 0 0 0 0 0 0 0 0 0 0 0 0 0 0 0 0 5 5 5 5 1 2 
2 1 1 1 1 1 1 1 1 0 0 0 0 0 0 0 0 0 0 1 1 1 1 1 1 1 1 2 
2 1 5 2 1 1 1 1 1 1 1 1 0 0 0 0 1 1 1 1 1 1 1 1 2 5 1 2 
5 5 5 2 1 1 1 1 1 1 1 1 1 1 1 1 1 1 1 1 1 1 1 1 2 5 5 5 
1 1 1 2 1 1 4 1 1 4 1 1 4 1 1 4 1 1 4 1 1 4 1 1 2 1 1 1 
1 1 1 2 1 1 1 1 1 1 1 1 1 1 1 1 1 1 1 1 1 1 1 1 2 1 1 1 
1 1 1 2 1 1 1 1 1 1 1 1 0 0 0 0 1 1 1 1 1 1 1 1 2 1 1 1 
1 1 1 2 1 1 1 1 1 0 0 0 0 0 0 0 0 0 0 1 1 ? 1 1 2 1 1 1 
1 1 1 2 1 1 0 0 0 0 0 0 0 0 0 0 0 0 0 0 0 0 1 1 2 1 1 1 
1 1 1 2 1 1 1 0 0 0 0 0 0 0 0 0 0 0 0 0 0 1 1 1 2 1 1 1 
1 1 1 2 1 1 1 1 0 0 0 0 0 0 0 0 0 0 0 0 1 1 1 1 2 1 1 1 
1 1 1 2 1 1 1 1 1 1 0 0 0 0 0 0 0 0 1 1 1 1 1 1 2 1 1 1 
