1 1 1 1 1 1 1 1 1 1 1 1 1 1 1 1 1 1 2 1 1 1 1 1 F 1 1 1 
1 1 1 1 1 1 1 1 3 3 1 1 1 1 1 1 1 1 2 1 1 1 1 1 - 1 1 1 
4 1 1 1 4 1 1 3 3 1 2 1 1 1 1 1 3 3 2 1 1 4 1 M - 1 1 1 
0 0 0 0 2 3 3 1 1 1 2 1 M 1 1 3 3 3 0 0 0 0 2 0 2 1 1 1 
1 1 1 1 2 1 1 5 0 0 0 2 1 1 3 3 3 4 0 4 1 1 1 0 2 1 1 1 
0 0 0 0 0 2 1 1 4 1 1 2 3 2 5 5 1 5 0 0 0 0 0 0 2 1 1 1 
0 4 1 1 1 2 1 1 5 1 1 1 1 2 1 1 1 5 5 5 5 1 3 3 2 1 1 1 
1 0 4 1 1 2 1 1 1 1 1 1 4 2 1 4 1 1 1 1 1 2 5 1 1 1 1 1 
1 1 0 4 1 2 0 0 0 0 2 5 5 5 5 5 5 2 0 0 5 2 5 1 1 1 1 1 
1 1 2 0 4 2 1 1 1 1 2 1 1 4 1 1 1 2 1 1 1 2 5 1 1 1 1 1 
1 1 2 1 0 2 5 1 1 1 2 0 0 0 0 0 0 2 0 0 5 2 5 1 1 1 1 1 
1 1 2 1 3 2 1 1 4 1 2 1 1 4 1 1 1 2 1 1 5 2 5 1 1 1 1 1 
1 1 2 5 1 4 1 1 5 1 2 0 0 0 0 0 0 2 1 5 4 2 4 5 1 1 1 1 
1 1 2 1 1 5 1 1 1 1 2 1 1 4 1 1 1 2 1 5 5 2 5 5 1 1 1 1 
1 1 2 1 1 1 1 1 1 1 2 0 0 0 0 0 0 2 1 1 1 2 M 1 1 1 1 1 
0 0 0 0 0 0 0 0 0 0 2 1 1 M 1 1 ? 2 0 0 0 0 0 0 0 0 0 0 
