F 1 1 4 1 F 1 1 1 1 3 1 3 1 1 M 1 1 F 3 1 1 1 1 1 1 3 F
2 0 0 0 1 2 0 0 0 0 4 0 4 0 0 0 0 0 2 1 3 1 1 1 1 3 1 2 
2 1 1 4 1 2 0 0 0 0 0 0 0 0 0 0 0 0 2 1 3 4 1 3 1 4 1 2 
2 0 0 0 1 2 0 0 4 0 0 0 0 0 4 0 0 0 2 3 1 1 3 1 3 1 3 2 
2 1 1 4 1 2 0 0 0 0 0 0 0 0 0 0 0 0 2 1 4 1 1 1 4 1 1 2 
2 0 0 0 1 2 0 4 0 0 0 0 0 0 0 4 0 0 2 1 3 3 1 1 3 1 1 2 
2 1 1 4 1 2 0 0 0 0 0 0 0 0 0 0 0 0 2 1 3 1 4 1 3 4 3 2 
2 0 0 0 1 2 0 0 4 0 0 0 0 0 4 0 0 0 2 1 1 1 3 1 1 3 1 2 
2 1 1 4 1 2 0 0 0 0 0 0 0 0 0 0 0 0 2 1 1 3 1 3 1 1 1 2 
2 0 0 0 1 2 0 0 0 4 0 0 0 4 0 0 0 0 2 3 1 1 3 1 3 1 3 2 
2 1 1 4 1 2 0 0 0 0 0 0 0 0 0 0 0 0 2 1 1 4 1 1 1 3 1 2 
2 0 0 0 1 2 0 0 0 0 4 0 4 0 0 0 0 0 2 1 1 1 3 3 1 4 1 2 
2 1 1 4 1 2 0 0 0 0 0 0 0 0 0 0 0 0 2 1 3 1 1 3 1 3 1 2 
2 0 0 0 1 2 0 0 0 4 0 0 0 4 0 0 0 0 2 1 4 1 3 1 3 1 3 2 
2 1 M 1 1 2 0 0 0 0 0 0 0 0 0 0 0 0 2 1 1 1 1 1 ? 1 1 1 
2 0 0 0 0 2 0 0 4 0 0 0 0 0 4 0 0 0 2 0 0 0 0 0 0 0 0 0 
