5 1 1 1 1 1 1 1 1 1 1 1 1 1 1 1 1 1 1 1 1 1 1 1 1 1 1 F 
5 1 1 1 1 1 4 4 4 4 M 1 M 1 M 1 1 1 1 1 1 ? 1 1 1 1 1 - 
5 0 0 0 0 0 0 0 0 0 0 0 0 0 0 0 0 0 0 0 0 0 0 0 0 0 0 2 
1 1 1 1 1 1 1 1 1 1 1 1 1 1 1 1 1 1 1 1 1 1 1 1 1 1 1 2 
1 1 1 1 5 1 4 1 1 4 1 1 1 1 1 1 1 4 1 1 1 1 1 1 4 5 1 2 
1 1 1 1 5 0 0 0 0 0 0 0 0 0 0 0 0 0 0 0 0 0 0 0 0 5 1 2 
1 1 1 1 1 1 1 1 1 1 1 1 1 1 1 1 1 1 1 1 1 1 1 1 1 1 1 2 
1 1 1 1 1 1 5 1 1 4 1 1 1 1 4 1 1 1 1 1 4 1 1 5 1 1 1 2 
1 1 1 1 1 1 5 0 0 0 0 0 0 0 0 0 0 0 0 0 0 0 0 5 1 1 1 2 
1 1 1 1 1 1 1 1 1 1 1 1 1 1 1 1 1 1 1 1 1 1 1 1 1 1 1 2 
1 1 1 1 1 1 1 5 1 1 4 1 1 1 1 1 4 1 1 1 1 4 5 1 1 1 1 2 
1 1 1 1 1 1 5 5 0 0 0 0 0 0 0 0 0 0 0 0 0 0 5 1 1 1 1 2 
1 1 1 1 1 1 1 1 1 1 1 1 1 1 1 1 1 1 1 1 1 1 1 1 1 1 1 2 
1 1 1 1 1 1 1 1 1 1 1 1 1 1 1 1 1 1 1 1 1 1 1 1 1 1 1 2 
4 4 4 4 1 1 1 M 1 1 1 1 1 1 1 1 1 1 M 1 1 1 1 1 2 5 1 2 
0 0 0 0 0 0 0 0 0 0 5 5 5 5 5 5 0 0 0 0 0 0 0 5 5 5 1 2 
