0 0 0 0 5 5 0 0 0 0 0 0 0 0 0 0 0 0 0 0 0 0 0 0 0 0 0 F 
0 1 4 1 1 5 1 1 1 1 1 4 1 1 M 1 1 1 1 1 1 1 1 ? 1 1 0 - 
0 2 0 2 1 5 0 0 0 2 0 0 0 0 0 0 0 0 0 0 0 0 0 0 0 1 0 - 
0 2 0 0 2 1 0 0 0 2 2 0 0 4 3 3 3 3 3 3 3 3 4 1 1 1 0 - 
0 2 1 0 0 2 1 0 0 0 2 2 0 0 4 1 1 1 4 1 1 4 0 0 2 1 0 - 
0 2 1 1 0 0 2 1 0 0 0 2 2 0 0 4 1 1 1 1 4 0 0 1 2 0 2 - 
0 2 2 1 1 0 0 2 1 0 0 2 2 2 0 0 4 1 1 4 0 0 1 1 2 2 2 - 
0 2 2 2 4 1 0 2 2 1 0 2 0 2 2 0 0 1 1 0 0 1 1 0 2 2 0 - 
0 2 2 2 2 1 1 2 0 2 1 2 0 0 2 2 0 0 0 0 1 1 0 2 2 2 0 - 
0 4 2 2 2 2 M 2 0 0 2 2 0 0 0 2 2 0 0 1 1 2 2 2 4 2 0 - 
0 2 2 4 1 1 2 2 1 0 0 2 1 0 0 0 2 0 1 4 0 2 2 2 2 0 0 - 
0 0 0 2 0 0 0 0 4 1 0 0 2 1 0 0 2 1 1 0 2 2 2 M 2 2 0 - 
0 2 2 2 2 2 2 2 2 1 1 0 2 2 1 2 2 M 2 2 2 4 1 1 2 2 0 - 
0 2 1 2 2 1 4 1 1 2 1 1 2 0 2 2 2 0 2 2 0 0 0 0 0 2 0 - 
0 4 1 2 0 2 0 0 0 0 2 1 1 1 1 1 2 2 2 4 1 1 1 1 1 2 1 - 
0 0 0 0 0 2 2 2 2 4 2 0 0 0 0 0 2 2 0 0 0 0 0 0 0 0 0 0 
