1 1 1 1 1 1 1 1 1 1 1 1 1 F F 1 1 1 1 1 1 1 1 1 1 1 1 1 
1 1 1 1 1 1 1 1 1 1 M M 1 - - 1 M M 1 1 1 1 1 1 1 1 1 1 
1 1 1 1 1 1 1 1 1 4 4 4 - 0 0 - 4 4 4 1 1 1 1 1 1 1 1 1 
1 1 1 4 4 4 4 4 - 5 5 5 5 5 5 5 5 5 5 - 4 4 4 4 4 1 1 1 
1 1 - 0 0 0 0 0 0 1 1 1 1 1 1 1 1 1 1 0 0 0 0 0 0 - 1 1 
1 1 - - - 1 1 1 1 1 1 1 1 1 1 1 1 1 1 1 1 1 1 - - - 1 1 
1 1 1 1 - 1 1 1 1 1 1 1 1 1 1 1 1 1 1 1 1 1 1 - 1 1 1 1 
1 1 1 1 - 1 1 1 1 1 1 1 1 1 1 1 1 1 1 1 1 1 1 - 1 1 1 1 
1 1 1 1 - 1 1 1 1 1 1 1 1 1 1 1 1 1 1 1 1 1 1 - 1 1 1 1 
1 1 1 1 - 1 1 1 1 1 1 1 1 1 1 1 1 1 1 1 1 1 1 - 1 1 1 1 
1 1 1 1 - 1 1 1 1 1 1 1 1 1 1 1 1 1 1 1 1 1 1 - 1 1 1 1 
1 1 1 1 - 1 1 1 1 1 1 1 1 1 1 1 1 1 1 1 1 1 1 - 1 1 1 1 
1 1 1 1 - 1 1 1 1 1 1 1 1 1 1 1 1 1 1 1 1 1 1 - 1 1 1 1 
1 1 1 1 - 1 1 1 1 1 1 1 1 1 1 1 1 1 1 1 1 1 1 - 1 1 1 1 
1 1 1 1 - 1 1 1 1 1 1 1 1 1 1 M 1 1 1 1 1 1 1 - 1 1 1 1 
5 0 0 0 0 0 0 5 0 0 0 0 0 5 5 0 0 0 0 0 5 0 0 0 0 0 0 5 
