F 1 1 1 1 1 1 1 1 1 1 1 1 0 0 1 1 1 1 1 1 1 1 1 1 1 1 F 
- 1 1 1 1 1 1 1 1 1 1 1 1 5 5 1 1 1 1 1 1 1 1 1 1 1 1 - 
- 1 4 1 1 1 1 1 1 1 4 1 1 0 0 1 1 4 1 1 1 1 1 1 1 4 1 - 
5 0 5 0 5 0 5 0 5 0 5 0 2 5 5 2 0 5 0 5 0 5 0 5 0 5 0 5 
1 1 1 4 1 1 1 1 1 4 1 1 2 0 0 2 1 1 4 1 1 1 1 1 4 1 1 1 
2 5 0 5 0 5 0 5 0 5 0 5 0 5 5 0 5 0 5 0 5 0 5 0 5 0 5 2 
2 1 1 1 4 M 1 M 4 1 1 1 1 0 0 1 1 1 1 4 M 1 M 4 1 1 1 2 
5 0 5 0 5 0 5 0 5 0 5 0 2 5 5 2 0 5 0 5 0 5 0 5 0 5 0 5 
1 1 1 1 1 1 1 1 4 1 1 1 2 0 0 2 1 1 1 4 1 1 1 1 1 1 1 1 
2 5 0 5 0 5 0 5 0 5 0 5 0 5 5 0 5 0 5 0 5 0 5 0 5 0 5 2 
2 1 1 4 1 1 1 1 1 4 1 1 1 0 0 1 1 1 4 1 1 1 1 1 4 1 1 2 
5 0 5 0 5 0 5 0 5 0 5 0 2 5 5 2 0 5 0 5 0 5 0 5 0 5 0 5 
1 1 4 1 1 1 1 1 1 1 4 1 2 0 0 2 1 4 1 1 1 1 1 1 1 4 1 1 
2 5 0 5 0 5 0 5 0 5 0 5 0 5 5 0 5 0 5 0 5 0 5 0 5 0 5 2 
2 1 1 1 1 1 1 1 1 1 1 1 1 ? 1 1 1 1 1 1 1 1 1 1 1 1 1 2 
0 5 0 5 0 5 0 5 0 5 0 5 0 5 0 5 0 5 0 5 0 5 0 5 0 5 0 5 
