1 1 1 1 1 1 1 1 1 1 1 1 1 1 1 1 1 1 M 1 1 1 1 1 1 1 1 F 
0 0 0 0 0 0 0 0 0 0 0 0 0 0 0 0 0 0 0 0 0 0 0 0 0 0 0 -
4 1 1 M 1 1 1 1 0 1 1 1 1 1 1 1 4 1 1 0 1 4 1 1 1 1 1 - 
0 0 0 2 0 1 0 2 0 2 0 0 0 0 0 0 0 0 1 0 2 0 1 0 0 2 0 0 
0 0 0 2 0 2 0 2 0 2 0 1 1 4 1 1 1 0 1 0 2 0 1 0 0 2 0 0 
0 0 0 2 0 2 0 1 0 2 0 1 0 0 0 0 1 0 1 0 2 0 1 1 1 2 1 2 
0 4 0 2 0 2 0 2 0 2 0 2 0 ? 1 0 1 0 1 0 2 0 1 0 0 0 0 2 
0 1 1 2 0 2 0 2 0 2 0 2 0 0 1 0 1 0 1 0 2 0 1 0 2 1 1 2 
1 2 0 2 0 2 0 2 0 2 0 2 1 1 4 0 1 0 1 0 2 0 1 0 2 0 0 0 
2 0 0 0 1 2 0 2 0 2 0 0 0 0 0 0 1 0 1 0 2 0 1 0 2 1 1 2 
2 0 0 1 0 2 0 2 0 2 1 4 1 1 1 1 1 0 1 0 2 1 3 0 0 0 0 2 
2 1 1 3 0 2 0 2 0 0 0 0 0 0 0 0 0 0 1 0 2 0 1 0 2 1 1 2 
2 0 0 1 0 2 0 2 1 1 1 1 1 1 1 1 1 1 1 0 2 0 1 0 2 0 0 0 
3 3 0 1 0 2 0 0 0 0 0 0 0 0 0 0 0 0 0 0 2 0 1 0 2 1 1 2 
1 1 1 1 1 2 1 1 1 1 1 1 M 1 1 1 1 1 1 1 2 0 1 0 0 0 0 2 
0 0 0 0 0 0 0 0 0 0 0 0 0 0 0 0 0 0 0 0 0 0 1 M 1 1 1 2 
