3 3 3 3 3 3 3 3 3 1 1 1 1 F 1 1 1 1 1 1 3 3 3 3 3 1 1 1 
1 1 1 1 1 1 1 1 1 2 1 1 1 1 2 1 1 1 1 2 1 1 1 1 1 1 1 1 
1 1 1 3 3 3 3 3 3 2 1 4 1 1 1 2 1 1 1 2 1 1 1 1 1 1 1 1 
1 1 2 1 4 1 M 1 1 0 0 0 1 1 1 2 1 1 1 1 2 1 1 1 1 1 1 1 
1 1 2 1 0 0 0 0 1 1 1 1 1 1 2 1 3 3 3 1 1 2 1 4 4 3 3 1 
1 1 2 1 1 1 1 1 1 1 1 1 1 2 1 1 1 4 1 1 1 2 1 5 5 1 1 1 
1 1 2 3 3 3 3 1 1 1 4 1 2 1 1 1 1 5 1 1 2 1 1 1 1 1 1 4 
1 1 1 1 1 1 1 2 1 0 0 1 2 1 1 1 1 1 1 2 1 1 1 1 1 1 1 0 
1 1 1 1 1 1 1 2 1 1 1 1 1 2 1 1 1 1 1 5 5 5 0 0 0 5 0 0 
1 1 1 1 1 1 1 2 1 1 1 1 1 1 2 1 3 3 1 1 1 1 1 1 1 1 1 1 
1 1 1 4 M 4 1 2 1 1 1 1 1 1 1 2 1 1 1 1 1 1 1 1 1 5 1 5 
1 1 0 0 0 0 1 2 3 3 3 3 1 1 1 2 1 1 1 5 5 5 5 5 5 5 1 5 
4 1 1 1 1 1 1 1 1 4 4 1 1 1 2 1 4 1 1 1 1 1 1 4 1 4 M 5 
5 1 1 1 1 1 1 1 1 5 5 1 1 2 1 1 0 1 1 0 0 0 0 0 0 0 0 0 
1 1 1 1 1 1 1 1 1 1 1 ? 1 2 1 1 1 1 1 1 1 1 1 1 1 1 1 1 
0 0 0 0 0 5 5 5 0 0 0 0 0 0 0 0 0 5 5 5 0 0 0 0 0 0 0 0 
