2 1 1 1 3 F 1 1 1 1 1 1 1 1 1 1 1 1 1 1 1 1 1 2 3 3 3 3 
2 1 1 1 1 2 1 1 1 1 1 1 1 1 1 1 1 1 1 1 1 1 1 2 1 5 1 1 
2 1 1 1 1 2 1 1 1 1 1 1 1 1 1 1 1 1 1 M 1 1 1 2 1 5 4 4 
2 1 4 1 1 2 0 0 0 0 1 1 4 1 1 4 2 0 0 0 0 0 0 0 2 0 0 0 
2 0 0 1 1 2 1 1 1 0 0 0 0 0 0 0 0 0 1 1 1 1 1 1 2 2 0 0 
2 1 1 1 1 2 1 1 1 1 1 1 1 1 1 1 1 1 1 1 1 1 1 1 1 2 2 0 
2 1 1 1 1 1 2 3 3 3 3 3 3 3 3 3 3 3 3 3 3 3 3 3 3 3 2 2 
2 1 1 1 1 1 2 1 1 1 1 1 1 1 1 1 1 1 1 1 1 1 1 1 1 1 1 2 
2 1 1 1 1 1 2 1 4 1 1 1 1 1 1 1 M 1 1 1 4 1 1 1 1 1 4 2 
2 1 1 1 1 1 0 0 0 0 0 2 5 5 5 5 5 5 5 5 5 5 0 0 0 0 0 0 
2 3 3 3 1 1 1 1 1 1 1 2 1 1 1 1 1 1 1 1 1 1 3 3 3 1 1 1 
1 1 1 M 4 1 1 1 1 1 1 2 1 1 1 1 1 1 1 1 1 2 1 1 1 1 1 1 
0 0 0 0 0 0 0 0 0 2 1 2 1 1 1 4 1 1 1 1 1 2 3 1 1 1 4 1 
1 1 1 1 1 1 1 1 0 0 0 0 0 2 5 5 5 2 0 0 0 0 1 0 4 0 0 0 
4 1 1 1 1 1 1 1 ? 1 1 1 1 2 1 1 1 2 1 1 1 M 1 0 0 0 0 0 
0 0 0 0 0 0 0 0 0 0 0 0 0 2 1 1 1 2 0 0 0 0 0 0 0 0 0 0 
