1 1 1 1 1 1 1 1 1 1 1 1 1 1 F 3 3 3 3 3 1 1 1 1 1 1 1 1 
1 1 1 1 1 1 1 1 1 1 3 3 3 3 2 1 1 1 1 1 M 4 1 1 4 1 1 1 
1 1 1 1 1 3 3 3 3 2 1 1 1 1 1 1 M 1 4 1 0 0 0 0 0 0 0 2 
1 3 3 3 2 1 1 1 1 1 1 1 1 1 4 1 0 0 0 0 0 1 1 4 1 1 0 2 
2 1 1 1 1 1 1 1 1 1 ? 4 1 0 0 0 0 1 1 1 4 M 0 0 0 2 0 2 
2 1 1 0 0 0 1 0 0 1 0 0 0 0 1 1 4 1 0 0 0 0 0 1 0 2 0 2 
2 1 1 4 1 4 1 4 1 1 0 1 1 4 1 0 0 0 0 1 1 4 1 1 0 2 0 2 
2 1 0 0 1 0 0 0 1 1 0 1 0 0 0 0 1 1 1 4 0 0 0 2 0 2 0 2 
2 1 1 4 1 4 1 4 1 1 0 1 0 1 1 4 1 0 0 0 0 1 0 2 0 2 0 2 
2 1 1 0 0 0 1 0 0 1 0 1 0 1 0 0 0 0 1 1 4 1 0 2 0 2 0 2 
2 1 1 4 1 4 1 4 1 1 0 1 0 1 0 1 1 4 1 0 0 2 0 2 0 2 0 2 
2 1 0 0 1 0 0 0 1 1 0 1 0 1 0 1 0 0 0 0 0 2 0 2 0 2 0 2 
2 1 1 4 1 4 1 4 1 1 0 1 0 1 0 1 0 1 1 1 0 2 0 2 0 2 0 2 
2 1 1 0 0 0 1 0 0 1 0 1 0 1 0 1 0 1 4 1 0 2 0 2 0 2 0 2 
2 1 1 1 1 1 1 1 1 M 0 1 0 1 0 1 0 0 0 0 0 2 0 2 0 2 0 2 
0 0 0 0 0 0 0 0 0 0 0 1 1 1 1 1 1 1 1 1 1 2 1 2 1 2 1 2 
