1 1 1 1 1 1 1 1 1 1 1 1 1 1 1 1 F 1 1 1 1 1 1 1 1 1 1 1 
1 M 3 1 1 1 1 1 1 1 1 1 3 ? 1 1 - 1 1 1 1 1 3 1 1 1 1 1 
1 2 1 2 1 1 1 1 1 1 1 2 1 2 1 1 - 1 1 1 1 2 1 2 1 1 1 2 
2 1 1 2 2 1 1 1 1 1 2 1 1 1 2 1 - 1 1 1 2 1 1 1 2 1 1 2 
1 0 4 2 1 2 1 1 1 2 1 0 4 0 1 2 - 1 1 2 1 0 4 0 1 2 3 2 
1 0 0 2 1 1 3 3 3 2 M 0 0 0 1 2 3 3 3 2 M 0 2 0 1 1 1 2 
5 0 0 2 0 0 0 0 0 5 0 0 5 0 0 5 0 0 0 0 0 5 2 0 0 0 0 2 
0 1 1 2 1 1 0 1 1 0 1 1 4 0 0 0 1 1 4 0 1 0 2 1 0 1 1 2 
0 3 3 2 3 3 0 3 3 0 1 2 0 3 3 3 3 2 3 3 3 3 2 3 0 3 3 2 
0 1 1 2 1 1 0 1 1 0 1 2 0 1 1 0 1 2 0 2 1 0 M 1 4 1 1 2 
0 0 5 2 0 5 0 0 5 0 0 2 0 0 5 0 0 5 0 2 5 0 0 5 0 0 0 2 
1 0 0 0 0 0 1 1 1 0 0 2 0 0 1 1 1 0 0 2 0 0 1 1 1 0 0 2 
1 1 1 2 3 3 3 1 3 3 0 2 0 3 3 1 3 3 0 2 0 3 3 1 3 3 0 2 
1 1 0 2 0 1 1 4 1 1 0 2 0 1 1 4 1 1 0 2 1 1 1 4 1 1 0 2 
1 4 0 2 0 1 1 5 1 1 0 2 0 1 1 5 1 1 0 2 0 1 1 5 1 1 0 2 
0 0 1 2 1 0 0 5 0 0 1 2 1 0 0 5 0 0 1 2 1 0 0 5 0 0 1 2 
