1 1 1 1 1 1 1 1 1 1 1 1 1 1 1 1 1 1 1 1 1 1 1 1 1 1 1 1 
1 1 1 1 1 1 1 1 1 1 1 1 1 1 1 1 1 1 1 1 1 1 1 1 1 1 1 1 
0 0 0 0 0 0 2 0 0 0 0 2 1 1 1 2 0 0 0 0 2 0 0 0 0 0 0 0 
1 3 1 1 1 1 2 1 1 1 1 2 5 2 5 2 1 1 1 1 2 1 1 1 1 1 3 1 
2 1 0 0 0 0 0 1 1 1 1 1 1 2 1 1 1 4 1 1 0 0 0 0 0 0 1 2 
2 1 0 0 0 0 0 1 1 0 2 2 2 2 2 2 2 0 1 1 0 0 0 0 0 0 1 2 
2 1 0 0 0 4 0 1 1 0 2 5 5 5 5 5 2 0 1 1 0 0 4 0 0 0 1 2 
2 1 0 0 0 0 0 1 1 0 2 2 2 2 2 2 2 0 1 1 0 0 0 0 0 0 1 2 
2 1 1 1 1 1 1 1 1 1 3 3 3 3 3 3 3 1 1 1 1 1 1 1 1 1 1 2 
2 1 1 1 1 1 2 1 1 1 1 1 1 5 1 1 1 1 1 1 2 1 1 1 1 1 1 2 
2 5 5 5 5 5 2 1 1 1 1 4 5 5 5 4 1 1 1 1 2 5 5 5 5 5 5 2 
2 1 1 1 1 1 2 1 1 1 1 5 5 5 5 5 1 1 1 1 2 1 1 1 1 1 1 2 
2 0 0 0 0 0 2 1 1 1 5 5 5 5 5 5 5 1 1 1 2 0 0 0 0 0 0 2 
2 1 1 1 1 1 2 1 4 5 5 5 5 5 5 5 5 5 4 1 2 1 1 1 1 1 1 2 
2 5 5 5 5 5 2 1 5 5 5 5 5 5 5 5 5 5 5 1 2 5 5 5 5 5 5 2 
4 1 1 1 1 1 2 5 5 5 5 5 5 5 5 5 5 5 5 5 2 1 1 4 1 1 1 4 
