5 5 5 5 5 5 5 5 5 5 5 5 5 5 5 5 5 5 5 5 5 5 1 1 1 1 1 5 
5 1 1 1 1 1 1 1 1 1 1 1 1 1 1 1 1 1 1 1 1 1 1 1 1 1 1 5 
5 1 1 1 1 2 0 5 0 0 5 5 0 2 5 1 1 1 1 1 1 1 1 1 1 1 1 5 
5 1 1 1 1 2 1 1 1 1 1 1 1 2 5 0 5 0 0 5 5 0 1 1 1 1 1 5 
5 1 0 0 5 2 1 1 1 1 1 2 1 2 0 1 0 1 1 0 3 3 3 3 3 3 3 5 
5 4 1 1 1 2 1 1 1 4 1 2 1 0 0 1 0 1 5 0 1 1 1 1 1 1 4 5 
5 1 1 1 1 2 1 1 1 2 1 2 1 0 1 1 0 1 1 0 1 1 1 1 1 1 1 5 
5 2 1 1 1 2 1 1 1 2 1 2 1 0 1 4 0 1 1 0 1 1 1 1 1 1 0 5 
5 2 1 1 1 2 1 1 1 2 1 5 0 0 1 1 0 0 1 0 1 1 1 1 1 4 0 5 
5 2 5 5 5 5 0 0 5 5 1 5 1 1 1 1 1 0 1 0 1 1 1 1 1 0 0 5 
5 2 1 3 3 3 3 3 3 3 3 5 3 3 3 3 3 0 1 0 1 1 4 1 1 1 0 5 
5 2 1 1 1 1 1 4 1 1 2 1 1 1 1 1 0 0 1 0 1 1 1 1 0 0 0 5 
5 2 1 1 2 5 0 5 5 5 2 5 5 5 0 2 0 1 1 0 1 1 1 4 0 1 1 5 
5 2 1 1 2 5 1 1 1 5 2 5 1 1 0 2 0 0 0 0 0 0 5 0 1 4 1 5 
5 2 1 1 2 5 1 1 1 5 2 5 4 1 0 2 1 1 1 1 1 1 1 1 0 0 5 5 
5 2 1 4 2 5 1 1 1 5 2 5 0 0 0 0 0 5 5 0 0 0 5 0 0 0 0 5 
