1 1 1 1 1 1 1 1 1 1 1 1 1 1 1 1 1 1 1 1 1 1 1 1 1 1 1 1 
1 1 1 1 1 1 1 1 1 1 1 1 1 1 1 1 1 1 1 1 1 1 1 1 1 1 1 1 
1 1 1 1 1 1 1 1 1 1 1 1 1 1 1 1 1 1 1 1 1 1 1 1 1 1 1 1 
1 1 1 1 1 1 1 1 1 1 1 1 1 1 1 1 1 1 1 1 1 1 1 1 1 1 1 1 
1 1 1 1 1 1 1 1 1 1 1 1 1 1 3 4 4 4 3 1 1 1 4 3 4 3 1 1 
4 4 3 1 1 1 4 3 4 3 1 1 1 1 1 1 1 1 1 1 1 1 1 1 1 2 4 0 
1 1 1 1 1 1 1 1 1 2 4 0 0 0 4 2 4 2 0 1 0 1 4 3 1 1 1 1 
4 2 0 1 0 1 4 3 1 1 1 1 1 1 1 1 1 1 1 1 4 2 0 0 0 0 0 2 
1 1 1 1 4 2 0 0 0 0 0 2 0 2 1 1 1 1 0 1 1 1 1 1 1 1 1 1 
1 1 0 1 1 1 1 1 1 1 1 1 1 1 4 1 0 2 0 0 4 0 0 2 1 2 1 1 
0 2 0 0 4 0 0 2 1 2 1 1 1 1 1 1 4 3 1 1 1 1 1 1 1 1 0 2 
4 3 1 1 1 1 1 1 1 1 0 2 3 2 0 0 0 0 0 2 1 2 1 1 1 1 1 1 
0 0 0 2 1 2 1 1 1 1 1 1 0 1 1 1 1 1 1 1 4 1 3 2 1 1 4 0 
1 1 1 1 4 1 3 2 1 1 4 0 0 0 4 1 1 2 1 1 1 1 1 1 1 1 1 1 
1 2 1 1 1 1 1 1 1 1 1 1 1 1 1 1 0 2 1 1 1 1 1 1 1 1 1 1 
0 2 1 1 1 1 1 1 1 1 1 1 1 2 1 1 1 1 1 1 1 1 4 1 1 1 1 1 
