1 1 3 3 3 1 1 1 1 1 1 4 1 1 4 1 1 1 1 3 3 3 1 1 5 1 0 2 
0 0 1 1 0 2 1 1 1 1 2 0 0 0 0 2 1 1 2 1 1 1 0 0 5 1 1 2 
1 0 0 1 0 2 1 1 1 2 0 0 0 0 0 0 0 0 0 0 2 1 0 0 5 1 0 2 
0 0 1 1 0 2 0 0 0 0 0 4 0 0 4 0 0 0 0 0 2 1 0 4 5 0 0 2 
4 0 0 4 0 2 1 1 1 1 1 1 1 1 1 1 1 1 1 1 2 1 1 1 1 1 0 2 
0 0 0 0 0 0 0 0 0 0 0 0 0 0 0 0 0 0 0 0 0 0 0 0 0 0 0 2 
1 1 1 4 1 1 1 1 1 4 1 1 1 1 1 1 1 1 1 1 1 1 1 1 1 1 1 2 
5 5 5 5 5 5 5 5 5 5 5 5 5 5 5 5 2 0 0 0 0 0 0 0 0 0 0 0 
1 3 3 3 3 3 3 3 3 3 3 3 3 3 1 5 2 1 1 1 1 1 1 1 1 1 1 1 
2 1 1 1 1 1 1 3 1 1 1 1 1 1 2 5 2 3 3 3 3 3 3 3 3 3 3 1 
2 1 1 1 1 1 3 1 3 1 1 1 1 1 2 5 0 0 1 0 0 1 0 0 1 0 0 2 
2 1 1 1 1 3 1 0 1 3 1 1 1 1 2 5 5 5 5 5 5 5 5 5 5 5 5 2 
2 1 1 1 3 1 0 0 0 1 3 1 1 1 2 3 3 3 3 3 3 3 3 3 3 3 3 2 
2 1 1 3 1 0 0 0 0 0 1 3 1 1 2 0 0 0 0 0 0 0 0 0 0 0 0 0 
2 1 3 1 0 0 4 4 4 0 0 1 3 1 2 5 1 1 1 1 1 1 1 1 1 1 1 1 
2 3 1 0 0 0 0 0 0 0 0 0 1 3 2 5 1 1 1 1 1 1 1 1 1 1 1 1 
