1 3 1 1 4 1 1 1 0 0 0 0 1 4 1 1 4 1 1 1 0 0 0 0 1 1 1 1 
4 1 1 1 0 0 0 0 1 1 1 1 2 1 2 0 0 0 0 2 0 0 0 0 2 0 0 0 
0 0 0 2 0 0 0 0 2 0 0 0 0 0 0 1 0 0 0 0 0 0 0 2 2 1 2 0 
0 0 0 0 0 0 0 2 2 1 2 0 0 0 0 2 1 1 4 1 2 0 0 0 4 0 0 1 
1 1 4 1 2 0 0 0 4 0 0 1 0 0 0 0 4 0 0 2 2 1 2 0 4 4 0 2 
4 0 0 2 2 1 2 0 4 4 0 2 0 0 0 0 0 0 0 0 0 0 0 1 1 1 1 0 
0 0 0 0 0 0 0 1 1 1 1 0 0 0 0 2 2 1 0 0 0 0 0 2 1 1 1 1 
2 1 0 0 0 0 0 2 1 1 1 1 1 3 3 3 3 3 3 3 3 3 3 3 3 3 3 2 
3 3 3 3 3 3 3 3 3 3 3 2 2 1 1 1 1 1 0 2 4 1 1 1 1 1 1 1 
1 1 0 2 4 1 1 1 1 1 1 1 1 4 1 1 4 1 1 1 1 1 1 1 2 0 0 0 
4 1 1 1 1 1 1 1 2 0 0 0 2 1 0 2 0 0 0 0 0 0 0 0 0 0 0 0 
0 0 0 0 0 0 0 0 0 0 0 0 0 2 1 4 1 4 1 1 2 4 1 0 2 1 0 2 
1 4 1 1 2 4 1 0 2 1 0 2 3 3 3 3 3 1 3 3 3 3 3 2 5 5 5 5 
3 1 3 3 3 3 3 2 5 5 5 5 5 5 5 5 0 0 1 0 2 1 0 2 1 1 1 1 
0 0 1 0 2 1 0 2 1 1 1 1 4 1 4 1 1 1 1 2 1 1 4 4 1 1 4 1 
1 1 1 2 1 1 4 4 1 1 4 1 1 1 1 4 2 1 0 2 0 0 0 0 0 0 0 0 
