1 1 1 1 1 1 1 1 1 1 1 1 1 1 1 1 1 1 1 1 1 1 1 1 1 1 1 1 
1 1 1 1 1 1 1 1 1 1 1 1 1 1 1 1 1 1 1 1 1 1 1 1 1 4 1 1 
1 1 1 1 1 1 1 1 1 4 1 1 1 1 1 1 1 1 1 1 1 1 1 1 3 3 3 1 
1 1 1 1 1 1 1 1 3 3 3 1 4 1 1 3 3 3 3 3 3 0 0 0 0 0 2 1 
3 3 3 3 3 0 0 0 0 0 2 1 1 1 1 4 1 1 1 1 2 0 0 5 0 0 0 1 
1 1 1 1 2 0 0 5 0 0 0 1 0 0 0 0 0 0 0 2 4 0 0 0 0 0 0 0 
0 0 0 2 4 0 0 0 0 0 0 0 0 0 0 2 2 0 0 4 0 0 0 1 5 4 1 1 
2 0 0 4 0 0 0 1 5 4 1 1 1 2 0 2 0 0 1 1 1 4 1 1 1 4 1 2 
0 0 1 1 1 4 1 1 1 4 1 2 2 0 0 0 0 0 0 1 5 5 5 5 5 2 5 2 
0 0 0 1 5 5 5 5 5 2 5 2 1 1 1 3 3 3 3 3 3 3 1 2 2 1 1 1 
3 3 3 3 3 3 1 2 2 1 1 1 1 1 1 1 1 3 3 3 3 2 1 2 1 1 1 2 
1 3 3 3 3 2 1 2 1 1 1 2 1 1 1 1 1 1 1 2 0 0 0 0 0 0 2 1 
1 1 1 2 0 0 0 0 0 0 2 1 1 1 1 1 1 1 1 2 1 1 1 2 1 1 0 1 
1 1 1 2 1 1 1 2 1 1 0 1 1 1 1 2 3 3 3 1 1 1 2 0 0 0 0 0 
3 3 3 1 1 1 2 0 0 0 0 0 0 1 0 0 0 0 0 0 0 2 0 0 0 0 0 0 
0 0 0 0 0 2 0 0 0 0 0 0 4 1 1 1 2 0 0 1 1 1 1 1 3 3 3 3 
