1 1 1 1 1 1 1 1 1 1 1 1 1 1 1 1 1 1 1 1 1 1 1 1 1 1 1 1 
1 1 1 1 1 1 1 1 1 1 1 1 1 1 1 1 1 1 1 1 1 1 1 1 1 1 1 1 
1 1 1 1 5 0 2 0 5 3 3 3 3 3 3 3 3 3 3 5 0 2 0 5 1 1 1 1 
1 1 1 1 5 4 2 1 5 1 4 1 1 1 1 1 1 4 1 5 1 2 1 5 1 1 1 1 
1 1 5 0 0 1 2 1 0 0 5 1 1 1 1 1 1 5 0 0 1 2 4 0 0 5 1 1 
1 1 5 4 1 1 2 1 1 4 5 1 4 1 1 1 4 5 1 4 1 2 1 0 4 5 1 1 
5 1 0 0 0 1 2 1 1 1 0 0 5 1 1 5 0 0 0 0 0 2 1 0 1 0 1 5 
5 1 1 1 1 1 2 1 1 1 1 1 5 1 4 5 4 1 1 1 1 2 1 0 1 1 4 5 
5 1 1 1 1 1 2 0 0 0 0 0 5 2 0 5 0 0 1 1 4 2 1 0 0 1 0 5 
5 1 4 1 1 1 2 1 1 1 1 1 1 2 1 1 1 1 1 0 0 2 1 1 1 1 1 5 
5 2 0 0 0 0 2 1 1 1 5 0 0 2 0 0 0 5 1 1 1 2 1 1 1 0 2 5 
1 2 5 1 4 1 2 1 1 1 0 1 1 2 1 4 1 0 1 1 1 2 1 1 1 5 2 1 
1 2 5 0 0 1 2 1 0 0 0 1 1 2 1 1 1 0 0 0 1 2 1 0 0 5 2 1 
1 2 1 4 5 1 2 1 5 1 1 1 1 2 1 1 1 1 4 5 1 2 1 5 4 1 2 1 
1 2 1 1 1 0 0 0 1 1 1 1 1 2 1 1 1 1 1 1 0 0 0 1 1 1 2 1 
0 0 0 0 0 0 0 0 0 0 0 0 0 0 0 0 0 0 0 0 0 0 0 0 0 0 0 0 
