1 1 1 1 1 1 1 1 1 1 1 1 1 1 1 1 1 1 1 1 1 1 1 1 1 1 1 1 
1 1 1 1 1 1 1 1 1 1 1 1 1 1 1 1 2 2 2 2 2 1 1 4 4 1 1 4 
2 2 2 2 2 1 1 4 4 1 1 4 4 1 1 2 2 2 2 2 1 1 1 1 1 1 1 1 
2 2 2 2 1 1 1 1 1 1 1 1 2 2 2 2 2 1 2 0 0 0 0 0 0 2 1 2 
2 1 2 0 0 0 0 0 0 2 1 2 2 2 1 2 1 1 1 1 1 1 2 0 2 1 2 1 
1 1 1 1 1 1 2 0 2 1 2 1 2 1 2 1 1 4 1 1 1 2 1 2 1 2 1 2 
1 4 1 1 1 2 1 2 1 2 1 2 0 2 1 1 1 1 2 0 2 1 2 1 2 1 2 0 
1 1 2 0 2 1 2 1 2 1 2 0 0 0 0 0 0 2 1 2 1 2 1 2 0 2 1 1 
0 2 1 2 1 2 1 2 0 2 1 1 1 1 1 0 2 1 2 1 2 3 2 1 1 4 1 4 
2 1 2 1 2 3 2 1 1 4 1 4 1 2 3 2 1 2 1 2 0 1 1 1 1 1 1 4 
1 2 1 2 0 1 1 1 1 1 1 4 5 1 2 1 5 3 0 0 0 0 0 0 0 0 3 5 
5 3 0 0 0 0 0 0 0 0 3 5 1 2 1 5 4 1 1 1 1 1 1 0 2 1 2 1 
4 1 1 1 1 1 1 0 2 1 2 1 2 3 2 0 0 0 0 0 0 2 3 2 1 2 1 2 
0 0 0 0 0 2 3 2 1 2 1 2 0 1 1 1 1 1 2 0 2 1 2 1 2 3 2 0 
1 1 2 0 2 1 2 1 2 3 2 0 0 0 0 0 0 2 3 2 1 2 1 2 0 2 1 1 
0 2 3 2 1 2 1 2 0 2 1 1 1 1 2 2 2 1 2 1 2 1 1 2 0 0 0 0 
