5 1 1 1 1 1 1 1 1 1 1 1 1 1 1 1 1 1 1 1 1 1 1 1 1 1 1 1 
1 1 1 1 1 1 1 1 1 1 1 1 5 1 1 1 1 1 4 4 4 4 1 1 1 1 1 1 
1 1 4 4 4 4 1 1 1 1 1 1 1 1 1 1 1 4 1 1 1 1 1 1 5 0 0 0 
1 4 1 1 1 1 1 1 5 0 0 0 0 0 0 0 0 0 0 0 0 0 0 0 0 0 0 0 
0 0 0 0 0 0 0 0 0 0 0 0 0 0 0 0 0 0 0 2 1 1 1 1 1 1 1 1 
0 0 0 2 1 1 1 1 1 1 1 1 1 1 1 1 1 1 1 1 1 1 1 1 1 1 1 1 
1 1 1 1 1 1 1 1 1 1 1 1 1 1 1 2 1 1 1 1 5 1 4 1 1 4 1 1 
1 1 1 1 5 1 4 1 1 4 1 1 1 1 1 1 1 4 1 1 1 1 1 1 4 5 1 2 
1 4 1 1 1 1 1 1 4 5 1 2 1 1 1 1 5 0 0 0 0 0 0 0 0 0 0 0 
5 0 0 0 0 0 0 0 0 0 0 0 0 0 0 0 0 0 0 0 0 5 1 2 1 1 1 1 
0 0 0 0 0 5 1 2 1 1 1 1 1 1 1 1 1 1 1 1 1 1 1 1 1 1 1 1 
1 1 1 1 1 1 1 1 1 1 1 1 1 1 1 1 1 1 1 2 1 1 1 1 1 1 5 1 
1 1 1 2 1 1 1 1 1 1 5 1 1 4 1 1 1 1 4 1 1 1 1 1 4 1 1 5 
1 1 4 1 1 1 1 1 4 1 1 5 1 1 1 2 1 1 1 1 1 1 5 0 0 0 0 0 
1 1 1 1 1 1 5 0 0 0 0 0 0 0 0 0 0 0 0 0 0 0 0 5 1 1 1 2 
0 0 0 0 0 0 0 5 1 1 1 2 1 1 1 1 1 1 1 1 1 1 1 1 1 1 1 1 
