1 4 1 1 1 1 1 1 1 1 1 1 1 1 1 1 1 1 1 1 1 1 1 1 1 1 1 1 
1 1 1 1 1 1 1 1 1 1 1 1 0 0 0 0 2 1 1 1 1 1 1 1 1 1 1 1 
2 1 1 1 1 1 1 1 1 1 1 1 1 1 1 1 1 1 1 1 1 1 1 1 1 1 4 1 
1 1 1 1 1 1 1 1 1 1 4 1 2 1 1 1 1 1 1 1 1 1 1 2 0 0 0 0 
1 1 1 1 1 1 1 2 0 0 0 0 0 0 2 1 1 1 4 1 0 0 0 0 0 0 0 0 
1 1 4 1 0 0 0 0 0 0 0 0 2 0 0 0 0 0 0 2 1 1 1 1 1 0 0 0 
0 0 0 2 1 1 1 1 1 0 0 0 0 0 0 0 1 1 1 1 1 1 1 1 2 1 1 1 
1 1 1 1 1 1 1 1 2 1 1 1 1 1 1 2 1 4 1 1 1 1 1 1 1 1 4 1 
1 4 1 1 1 1 1 1 1 1 4 1 1 1 1 1 1 4 1 1 2 1 1 1 1 1 1 2 
1 4 1 1 2 1 1 1 1 1 1 2 0 0 0 0 0 0 0 0 0 0 0 0 0 2 0 0 
0 0 0 0 0 0 0 0 0 2 0 0 0 0 0 0 2 1 1 1 4 1 1 2 1 1 1 1 
2 1 1 1 4 1 1 2 1 1 1 1 1 1 1 1 1 1 1 1 1 2 1 1 1 4 1 1 
1 1 1 1 1 2 1 1 1 4 1 1 2 5 5 5 5 5 5 2 1 1 1 1 1 1 4 1 
5 5 5 2 1 1 1 1 1 1 4 1 1 1 1 1 0 2 0 0 0 0 0 0 2 1 1 1 
0 2 0 0 0 0 0 0 2 1 1 1 1 1 1 0 0 0 0 0 2 0 0 0 0 0 0 2 
0 0 0 0 2 0 0 0 0 0 0 2 1 1 1 1 1 1 1 1 2 1 1 1 1 1 1 4 
