0 0 0 0 0 0 0 0 0 0 0 0 1 1 0 0 0 0 0 0 0 0 0 0 0 0 0 0 
0 0 0 0 0 0 0 0 0 0 0 0 0 3 3 3 3 3 3 3 3 3 0 1 1 1 1 0 
3 3 3 3 3 3 0 1 1 1 1 0 3 3 3 3 3 3 3 3 3 0 1 1 1 0 4 1 
3 3 3 3 3 0 1 1 1 0 4 1 1 2 1 1 4 0 1 1 1 1 1 1 0 4 1 1 
4 0 1 1 1 1 1 1 0 4 1 1 2 1 1 4 0 1 1 1 1 1 0 4 1 2 1 4 
0 1 1 1 1 1 0 4 1 2 1 4 0 1 1 1 1 1 1 1 1 0 4 1 2 1 4 0 
1 1 1 1 1 0 4 1 2 1 4 0 1 1 1 1 1 1 1 0 4 2 4 0 1 1 1 1 
1 1 1 0 4 2 4 0 1 1 1 1 1 1 1 1 1 1 0 4 2 4 0 1 1 1 1 1 
1 1 0 4 2 4 0 1 1 1 1 1 1 1 1 1 0 2 0 1 1 1 1 1 1 5 5 5 
0 2 0 1 1 1 1 1 1 5 5 5 5 5 0 0 2 0 1 1 1 1 1 1 1 4 1 1 
2 0 1 1 1 1 1 1 1 4 1 1 0 2 0 1 1 1 1 1 1 5 1 1 1 4 1 0 
1 1 1 1 1 5 1 1 1 4 1 0 2 0 1 1 1 1 1 1 0 0 0 2 0 2 0 0 
1 1 1 1 0 0 0 2 0 2 0 0 0 0 0 0 0 0 0 0 0 1 0 0 2 0 0 0 
0 0 0 0 0 1 0 0 2 0 0 0 0 0 0 2 1 1 1 2 1 2 1 1 1 1 1 1 
1 1 1 2 1 2 1 1 1 1 1 1 1 1 1 1 1 1 1 0 2 1 1 1 1 1 1 2 
1 1 1 0 2 1 1 1 1 1 1 2 2 0 0 5 0 2 0 0 0 0 0 0 0 0 0 0 
