1 1 1 1 1 1 3 3 3 3 3 3 3 3 3 3 3 4 1 1 1 1 1 1 1 1 1 1 
3 4 1 1 1 1 1 1 1 1 1 1 5 5 5 5 5 5 1 1 1 0 0 1 1 1 1 1 
5 5 1 1 1 0 0 1 1 1 1 1 0 5 5 5 5 5 5 0 2 1 1 1 5 3 3 3 
5 5 5 0 2 1 1 1 5 3 3 3 3 3 3 1 1 4 4 1 1 1 1 1 0 1 1 1 
1 4 4 1 1 1 1 1 0 1 1 1 1 1 1 0 2 1 1 1 5 2 1 1 1 1 1 1 
2 1 1 1 5 2 1 1 1 1 1 1 0 0 0 0 1 1 1 1 0 1 1 1 1 1 4 0 
1 1 1 1 0 1 1 1 1 1 4 0 2 1 1 1 5 2 4 4 1 1 1 1 4 1 1 4 
5 2 4 4 1 1 1 1 4 1 1 4 1 1 1 1 0 0 0 0 0 0 0 0 2 1 1 1 
0 0 0 0 0 0 0 0 2 1 1 1 5 5 5 5 2 1 4 1 0 0 0 0 1 1 1 1 
2 1 4 1 0 0 0 0 1 1 1 1 1 1 1 1 1 1 1 2 2 1 1 1 1 1 1 1 
1 1 1 2 2 1 1 1 1 1 1 1 2 1 1 1 1 1 1 1 4 1 1 1 4 1 1 1 
1 1 1 1 4 1 1 1 4 1 1 1 1 3 3 1 2 1 1 1 1 1 1 1 2 1 1 1 
2 1 1 1 1 1 1 1 2 1 1 1 1 1 0 5 5 5 5 5 5 5 5 5 0 3 3 1 
5 5 5 5 5 5 5 5 0 3 3 1 2 1 1 1 1 1 1 1 2 4 1 1 4 1 0 1 
1 1 1 1 2 4 1 1 4 1 0 1 1 1 1 1 1 4 1 1 0 1 1 1 2 1 1 1 
1 4 1 1 0 1 1 1 2 1 1 1 1 1 1 1 2 0 0 0 0 2 0 0 0 0 0 0 
