1 1 1 1 1 1 1 1 1 1 1 1 1 1 1 1 1 1 1 1 1 1 1 1 1 1 1 1 
1 1 1 1 1 1 1 1 1 1 1 1 1 1 1 4 1 1 1 1 1 1 1 1 1 1 1 1 
1 1 1 1 1 1 1 1 1 1 1 1 1 1 1 1 1 1 1 1 1 1 1 1 2 5 0 0 
1 1 1 1 1 1 1 1 2 5 0 0 1 1 1 1 1 1 1 1 1 1 1 1 1 1 1 1 
1 1 1 1 1 1 1 1 1 1 1 1 1 1 1 1 1 5 5 2 2 5 4 0 0 1 4 1 
1 5 5 2 2 5 4 0 0 1 4 1 1 1 1 1 1 1 1 1 1 1 1 1 1 1 1 4 
1 1 1 1 1 1 1 1 1 1 1 4 1 5 5 2 2 1 1 0 4 0 0 0 1 1 1 1 
2 1 1 0 4 0 0 0 1 1 1 1 1 1 1 1 1 1 4 1 0 0 0 0 0 0 0 2 
1 1 4 1 0 0 0 0 0 0 0 2 2 1 1 0 1 0 1 1 0 0 0 4 1 1 1 1 
1 0 1 1 0 0 0 4 1 1 1 1 1 0 0 0 1 4 1 1 1 1 1 2 2 3 3 1 
1 4 1 1 1 1 1 2 2 3 3 1 1 0 4 1 0 1 1 0 1 1 4 1 0 0 4 1 
0 1 1 0 1 1 4 1 0 0 4 1 5 5 5 5 1 1 1 2 2 1 1 0 0 0 0 0 
1 1 1 2 2 1 1 0 0 0 0 0 0 1 1 1 0 0 0 0 0 1 1 1 1 1 1 0 
0 0 0 0 0 1 1 1 1 1 1 0 0 0 5 2 2 4 1 1 1 1 1 1 1 1 1 1 
2 4 1 1 1 1 1 1 1 1 1 1 1 1 1 1 1 0 5 5 5 2 0 1 4 1 1 2 
1 0 5 5 5 2 0 1 4 1 1 2 2 5 5 5 5 3 3 3 3 3 3 3 3 1 1 1 
