1 1 0 0 0 0 0 0 0 0 0 0 0 0 0 0 0 0 0 0 0 0 0 0 0 0 0 1 
0 0 0 0 0 0 0 0 0 0 0 1 0 1 3 3 3 3 3 3 3 3 3 3 3 3 3 3 
3 3 3 3 3 3 3 3 3 3 3 3 3 3 3 3 3 3 3 3 3 3 1 0 0 1 0 5 
3 3 3 3 3 3 1 0 0 1 0 5 5 5 0 5 5 5 0 5 5 5 0 5 5 0 5 2 
5 5 0 5 5 5 0 5 5 0 5 2 0 5 3 3 3 0 2 0 0 1 0 1 1 1 1 4 
3 0 2 0 0 1 0 1 1 1 1 4 1 1 1 1 4 1 1 1 4 1 1 2 1 1 1 4 
4 1 1 1 4 1 1 2 1 1 1 4 2 0 2 0 0 1 4 2 5 5 5 5 5 5 5 5 
0 1 4 2 5 5 5 5 5 5 5 5 5 5 5 5 5 5 5 5 5 5 5 5 2 5 2 0 
5 5 5 5 5 5 5 5 2 5 2 0 0 1 0 2 0 3 3 3 3 3 3 3 3 3 3 3 
0 3 3 3 3 3 3 3 3 3 3 3 3 3 3 3 3 5 1 4 2 0 2 0 0 1 4 2 
3 5 1 4 2 0 2 0 0 1 4 2 0 1 5 5 5 5 5 5 5 5 5 5 5 5 5 5 
5 5 5 5 5 5 5 5 5 5 5 5 5 5 0 0 0 0 2 0 0 1 0 2 0 1 5 1 
0 0 2 0 0 1 0 2 0 1 5 1 4 4 4 4 4 4 4 4 4 4 4 4 1 1 1 4 
4 4 4 4 4 4 4 4 1 1 1 4 0 4 2 0 0 1 4 2 0 1 5 0 0 0 5 5 
0 1 4 2 0 1 5 0 0 0 5 5 5 5 5 5 0 5 5 5 5 5 2 0 0 0 2 0 
0 5 5 5 5 5 2 0 0 0 2 0 0 1 0 2 0 1 1 1 1 1 1 1 1 1 1 1 
