1 1 1 1 1 1 1 1 1 1 1 1 1 1 1 1 1 1 1 1 1 1 1 1 1 1 1 1 
1 1 1 1 1 1 1 1 1 1 1 1 0 2 0 2 0 2 0 2 0 2 0 2 0 2 0 2 
0 2 0 2 0 2 0 2 0 2 0 2 0 2 0 2 0 2 0 2 0 2 0 1 0 2 0 2 
0 2 0 2 0 2 0 1 0 2 0 2 0 2 0 2 0 2 0 2 0 2 0 2 0 2 0 2 
0 2 0 2 0 2 0 2 0 2 0 2 0 2 0 2 0 2 0 1 4 2 0 2 1 2 0 2 
0 2 0 1 4 2 0 2 1 2 0 2 4 2 0 2 1 2 0 2 4 2 0 2 1 2 0 2 
1 2 0 2 4 2 0 2 1 2 0 2 4 2 0 1 0 2 0 2 0 2 0 2 0 2 0 2 
0 2 0 2 0 2 0 2 0 2 0 2 0 2 0 2 0 2 0 2 0 2 0 2 0 2 0 1 
0 2 0 2 0 2 0 2 0 2 0 1 0 2 0 2 0 2 0 2 0 2 0 2 0 2 0 2 
0 2 0 2 0 2 0 2 0 2 0 2 0 2 0 2 0 2 0 2 0 2 0 1 0 2 0 2 
0 2 0 2 0 2 0 1 0 2 0 2 0 2 0 2 0 2 0 2 0 2 0 2 0 2 0 2 
0 2 0 2 0 2 0 2 0 2 0 2 0 2 0 2 0 2 0 1 1 2 0 2 4 2 0 2 
0 2 0 1 1 2 0 2 4 2 0 2 1 2 0 2 4 2 0 2 1 2 0 2 4 2 0 2 
4 2 0 2 1 2 0 2 4 2 0 2 1 2 0 1 0 2 0 2 0 2 0 2 0 2 0 2 
0 2 0 2 0 2 0 2 0 2 0 2 0 2 0 2 0 2 0 2 0 2 0 2 0 2 0 1 
0 2 0 2 0 2 0 2 0 2 0 1 0 2 0 2 0 2 0 2 0 2 0 2 0 2 0 2 
