1 1 1 1 1 1 1 1 1 1 1 1 1 2 2 3 3 3 3 2 2 2 2 2 0 0 0 0 
1 1 1 1 1 1 1 1 1 1 1 1 2 0 0 2 3 3 3 2 4 4 1 2 0 0 0 0 
1 1 1 1 1 1 1 1 1 1 1 2 0 0 0 0 2 1 1 1 2 2 4 2 1 2 1 2 
1 1 1 1 1 1 1 1 1 1 2 0 0 0 0 0 0 2 1 1 1 1 2 2 4 2 4 2 
1 1 1 1 1 1 1 1 1 1 2 0 0 0 0 0 0 2 1 1 1 1 1 2 2 2 2 2 
1 1 1 1 1 1 1 1 1 1 2 0 5 0 5 0 5 2 1 1 1 1 1 2 1 2 1 2 
1 1 1 1 1 1 1 1 1 1 2 4 5 0 5 0 4 2 1 1 1 1 1 2 1 2 1 2 
1 1 1 1 1 1 1 1 1 1 2 0 5 0 5 0 5 2 1 1 1 1 1 2 4 2 4 2 
4 3 3 3 3 3 3 3 3 3 2 0 5 0 5 0 5 2 1 1 1 1 1 2 2 2 2 2 
2 4 1 1 1 1 1 1 1 1 2 4 5 0 5 0 4 2 1 1 1 1 1 2 1 2 1 2 
0 2 4 1 1 1 1 1 1 1 2 0 5 0 5 0 5 2 1 1 1 1 1 2 1 2 1 2 
0 0 2 4 1 1 1 1 1 1 2 0 5 0 5 0 5 2 1 1 1 1 1 2 4 2 4 2 
0 0 0 2 4 1 1 1 1 1 2 4 0 0 0 0 4 2 1 1 1 1 1 2 2 2 2 2 
0 0 0 0 2 4 1 1 1 1 2 0 0 0 0 0 0 2 1 1 1 1 1 2 1 2 1 2 
0 0 0 0 0 2 4 1 1 2 5 0 1 0 5 1 0 5 2 1 1 1 1 2 4 2 4 2 
0 0 0 0 0 0 2 1 1 2 5 0 1 0 5 1 0 5 2 1 1 2 0 0 0 0 0 0 
